City,Businesses,1 Star Reviews,2 Star Reviews,3 Star Reviews,4 Star Reviews,5 Star Reviews,Positive Reviews,Negative Reviews,All Reviews Count,Average Rating
Richmond Heights,15,47,31,37,67,109,176,78,291,3.549828178694158
Charlotte,7557,26729,19109,28124,57631,80752,138383,45838,212345,3.690235230403353
Toronto,15483,41103,40169,68205,123782,118468,242250,81272,391727,3.6084415932524436
Scottsdale,7510,34652,21197,26804,58711,138352,197063,55849,279716,3.87558094638848
Phoenix,15656,75889,39507,49495,110189,244166,354355,115396,519246,3.784283364725005
Pittsburgh,5688,17117,14569,22085,45470,63134,108604,31686,162375,3.757105465742879
McMurray,67,143,118,122,219,352,571,261,954,3.5440251572327046
Gilbert,2835,13470,6641,6956,14842,43252,58094,20111,85161,3.7957280914972817
Las Vegas,24768,202085,119988,172714,330466,631012,961478,322073,1456265,3.7336109842645397
Mesa,5146,20111,8810,9645,20523,56339,76862,28921,115428,3.729190491042035
Avondale,573,2853,1256,1343,2808,6485,9293,4109,14745,3.597897592404205
Matthews,583,1467,908,1111,2255,4351,6606,2375,10092,3.705013872374158
Stanley,14,14,6,9,16,43,59,20,88,3.772727272727273
Cleveland,2979,9233,7479,10916,23235,33700,56935,16712,84563,3.7649917812754987
Pineville,273,827,425,533,1045,2001,3046,1252,4831,3.6143655557855516
Mississauga,2316,5716,3949,6613,11304,10295,21599,9665,37877,3.4359637774902976
Edinburgh,3625,2058,2935,8429,17922,15071,32993,4993,46415,3.8836152106000217
Montréal,5175,7950,8033,15586,36119,41720,77839,15983,109408,3.874031149458906
Rocky River,206,561,526,636,1269,1988,3257,1087,4980,3.722289156626506
Madison,2891,7954,7442,10473,22639,30879,53518,15396,79387,3.768979807777092
Pickering,229,365,271,418,753,642,1395,636,2449,3.423029808084933
Richmond Hill,770,2184,1859,3566,5100,3444,8544,4043,16153,3.356652015105553
Middleton,288,687,723,930,1670,2122,3792,1410,6132,3.6224722765818655
Beachwood,229,659,439,569,954,1276,2230,1098,3897,3.4488067744418784
Chandler,3649,16696,8831,10417,22369,50933,73302,25527,109246,3.7507094081247825
Ajax,206,339,215,278,604,735,1339,554,2171,3.54398894518655
North York,944,2277,1685,2978,4500,3265,7765,3962,14705,3.3258075484529073
Parma Heights,50,131,51,65,114,205,319,182,566,3.372791519434629
Mc Kees Rocks,33,60,17,20,79,169,248,77,345,3.8115942028985508
Champaign,1084,3513,2480,3402,5951,8742,14693,5993,24088,3.578254732646961
Montreal,229,343,357,753,1667,1770,3437,700,4890,3.8515337423312883
Tempe,3949,21626,12092,15232,32018,67106,99124,33718,148074,3.7488553020786903
Indian Trail,206,452,207,220,491,1156,1647,659,2526,3.669833729216152
Stuttgart,1975,2184,2387,3831,7407,9312,16719,4571,25121,3.7673261414752597
Painesville,87,149,88,120,237,391,628,237,985,3.6426395939086293
Urbana,355,915,672,843,1818,2926,4744,1587,7174,3.720379146919431
Brecksville,59,129,104,137,244,367,611,233,981,3.6279306829765545
Glasgow,3,0,0,1,7,2,9,0,10,4.1
Bedford,85,217,49,73,145,264,409,266,748,3.2540106951871657
Glendale,2841,12559,5683,6427,12309,30542,42851,18242,67520,3.6308056872037913
Harrisburg,96,186,114,110,291,500,791,300,1201,3.6702747710241463
Cave Creek,335,1234,756,778,1728,4400,6128,1990,8896,3.821043165467626
Rosemere,11,4,3,11,24,13,37,7,55,3.709090909090909
Markham,1390,3832,3885,8001,11249,6956,18205,7717,33923,3.4012616808654896
Sun City,188,510,158,174,358,1208,1566,668,2408,3.6627906976744184
Verona,142,187,163,209,452,896,1348,350,1907,3.8951232302045096
North Las Vegas,1254,6831,2550,2918,5807,14969,20776,9381,33075,3.5905668934240365
Northfield,72,156,81,116,245,352,597,237,950,3.5852631578947367
Murrysville,86,124,113,128,271,449,720,237,1085,3.744700460829493
Lakewood,449,1212,1084,1480,3532,6109,9641,2296,13417,3.912424536036372
Strongsville,289,711,495,594,1196,1791,2987,1206,4787,3.597660330060581
Goodyear,703,3724,1730,1804,3457,8352,11809,5454,19067,3.576021398227304
Vaughan,650,1444,1123,1704,3130,3053,6183,2567,10454,3.4998086856705566
Willoughby,193,454,287,384,732,1028,1760,741,2885,3.5521663778162913
Inverness,174,114,102,190,404,441,845,216,1251,3.7641886490807352
Gastonia,353,879,494,562,998,1653,2651,1373,4586,3.4474487570867858
Wexford,223,484,286,378,693,1159,1852,770,3000,3.5856666666666666
Henderson,4130,22979,10778,13267,27841,72700,100541,33757,147565,3.789516484261173
Peoria,1527,7110,3135,3228,6238,17385,23623,10245,37096,3.637615915462584
Mentor,351,781,501,493,974,1770,2744,1282,4519,3.5423766319982297
Huntersville,503,1328,874,1245,2594,4374,6968,2202,10415,3.7500720115218433
Whitby,266,299,230,311,651,872,1523,529,2363,3.6631400761743547
North Olmsted,310,780,495,593,1081,1801,2882,1275,4750,3.5532631578947367
Elyria,126,225,114,131,308,444,752,339,1222,3.5171849427168578
Brossard,136,157,159,220,377,298,675,316,1211,3.4128819157720893
Fitchburg,174,438,385,449,882,1120,2002,823,3274,3.568417837507636
Scarborough,870,1827,1422,2589,4241,3171,7412,3249,13250,3.415622641509434
Middleburg Heights,95,240,145,165,296,446,742,385,1292,3.4357585139318885
Allison Park,69,113,66,73,193,347,540,179,792,3.7512626262626263
Tolleson,112,516,170,172,366,877,1243,686,2101,3.4369347929557352
Concord,726,1924,1167,1496,2766,4245,7011,3091,11598,3.5381100189687875
East Gwillimbury,18,22,13,24,42,54,96,35,155,3.6
Lorain,81,117,45,59,170,287,457,162,678,3.685840707964602
Monroeville,316,756,504,666,1254,1444,2698,1260,4624,3.45977508650519
Bethel Park,139,297,169,198,379,651,1030,466,1694,3.541912632821724
Stallings,18,21,27,36,113,203,316,48,400,4.125
Mayfield Heights,125,385,216,229,443,575,1018,601,1848,3.3284632034632033
Cuyahoga Falls,257,630,461,522,1026,1697,2723,1091,4336,3.622463099630996
Irwin,96,149,129,131,258,350,608,278,1017,3.52212389380531
Brampton,690,1193,809,1296,2400,2427,4827,2002,8125,3.499569230769231
Mc Farland,26,41,23,27,66,70,136,64,227,3.444933920704846
Surprise,934,4483,2117,2081,4111,9873,13984,6600,22665,3.5636002647253475
Saint-Hubert,17,5,4,11,27,43,70,9,90,4.1
Mascouche,2,0,4,5,4,3,7,4,16,3.375
Canonsburg,127,206,145,166,383,651,1034,351,1551,3.727272727272727
Saint-Leonard,32,29,20,37,49,48,97,49,183,3.366120218579235
Laveen Village,11,31,9,14,31,86,117,40,171,3.7719298245614037
Boulder City,248,627,372,658,1704,4162,5866,999,7523,4.116841685497807
Eastlake,45,84,49,67,101,264,365,133,565,3.729203539823009
Fellbach,93,59,71,127,185,289,474,130,731,3.7852257181942544
Millvale,8,7,2,9,28,66,94,9,112,4.285714285714286
Tuscola,25,37,21,21,65,91,156,58,235,3.646808510638298
Etobicoke,592,1293,967,1472,2733,2583,5316,2260,9048,3.4803271441202477
Oakville,540,826,661,992,1785,1962,3747,1487,6226,3.5454545454545454
Penn Hills,22,18,7,18,32,57,89,25,132,3.7803030303030303
Plum,13,9,11,14,40,54,94,20,128,3.9296875
Chagrin Falls,143,247,193,262,576,1080,1656,440,2358,3.8689567430025447
Fort Mill,483,1121,651,783,1625,2965,4590,1772,7145,3.652484254723583
Chardon,44,67,37,67,135,232,367,104,538,3.795539033457249
Hinckley,13,17,2,7,20,50,70,19,96,3.875
McKeesport,45,39,27,32,68,158,226,66,324,3.861111111111111
Streetsboro,112,270,164,133,318,460,778,434,1345,3.3970260223048325
Enterprise,7,51,30,28,55,85,140,81,249,3.3734939759036147
Brook Park,41,87,37,42,81,220,301,124,467,3.663811563169165
Monona,108,245,200,235,441,601,1042,445,1722,3.5534262485481998
York,89,152,60,108,260,312,572,212,892,3.5829596412556053
Thornhill,296,871,623,1197,1905,1497,3402,1494,6093,3.415887083538487
Stow,182,401,235,256,543,985,1528,636,2420,3.6099173553719006
Laval,293,283,285,405,793,665,1458,568,2431,3.523241464417935
North Randall,5,12,12,13,41,75,116,24,153,4.0130718954248366
Stuttgart-Vaihingen,2,1,1,2,0,3,3,2,7,3.4285714285714284
Coraopolis,146,361,219,293,596,829,1425,580,2298,3.571366405570061
McKees Rocks,52,49,36,45,117,260,377,85,507,3.992110453648915
Castle Shannon,9,12,5,8,13,29,42,17,67,3.626865671641791
East York,119,191,116,188,397,490,887,307,1382,3.6360347322720696
Newhaven,12,2,3,5,30,27,57,5,67,4.149253731343284
las vegas,28,94,33,20,65,647,712,127,859,4.324796274738068
Concord Mills,4,47,51,55,46,35,81,98,234,2.876068376068376
Schönaich,12,2,6,10,16,37,53,8,71,4.126760563380282
Valley City,8,12,13,16,57,70,127,25,168,3.9523809523809526
North Ridgeville,71,106,74,80,165,345,510,180,770,3.738961038961039
Kent,223,503,382,441,903,1468,2371,885,3697,3.6629699756559373
Litchfield Park,181,729,445,497,904,2081,2985,1174,4656,3.6793384879725086
Savoy,67,116,79,82,183,324,507,195,784,3.663265306122449
Avon,168,408,293,303,534,1087,1621,701,2625,3.609142857142857
Valley View,20,66,82,112,258,358,616,148,876,3.867579908675799
Kornwestheim,29,22,9,18,42,83,125,31,174,3.8908045977011496
Bonnyrigg and Lasswade,1,0,1,0,1,3,4,1,5,4.2
Verdun,127,98,110,244,490,424,914,208,1366,3.7554904831625184
Bay Village,33,44,28,37,110,214,324,72,433,3.97459584295612
Euclid,73,111,64,89,171,251,422,175,686,3.564139941690962
North Royalton,101,155,90,114,272,480,752,245,1111,3.748874887488749
Cornelius,369,745,517,561,1449,2826,4275,1262,6098,3.8353558543784847
Trafford,12,18,10,13,22,45,67,28,108,3.611111111111111
Chesterland,49,83,56,72,205,370,575,139,786,3.9198473282442747
Cottage Grove,27,31,36,33,63,98,161,67,261,3.6168582375478926
Berea,89,166,128,181,442,718,1160,294,1635,3.8672782874617737
Parma,206,506,296,417,956,1675,2631,802,3850,3.7787012987012987
Waiblingen,48,29,38,58,95,121,216,67,341,3.7067448680351904
Kannapolis,119,210,102,116,215,466,681,312,1109,3.563570784490532
Westlake,311,958,671,805,1525,2263,3788,1629,6222,3.556734169077467
Unionville,36,112,153,269,493,298,791,265,1325,3.537358490566038
Sun Prairie,189,401,280,382,718,1116,1834,681,2897,3.644804970659303
Dravosburg,9,15,4,4,11,24,35,19,58,3.4310344827586206
Whitchurch-Stouffville,35,47,38,65,201,181,382,85,532,3.8101503759398496
Solon,179,440,350,396,742,1006,1748,790,2934,3.5194274028629855
Lyndhurst,91,335,304,352,543,571,1114,639,2105,3.337767220902613
Cleveland Heights,179,582,593,794,1916,2547,4463,1175,6432,3.81669776119403
Saint-Philippe,1,1,1,2,5,1,6,2,10,3.4
Belmont,123,236,193,225,452,873,1325,429,1979,3.774633653360283
Kirkcaldy,19,4,5,21,25,16,41,9,71,3.619718309859155
Old Town,5,1,1,9,14,13,27,2,38,3.973684210526316
Fountain Hills,278,687,403,396,871,2392,3263,1090,4749,3.8165929669404086
Sun City West,72,182,63,41,121,353,474,245,760,3.526315789473684
Sainte-Julie,11,4,7,12,19,4,23,11,46,3.260869565217391
Lasalle,61,62,42,80,122,113,235,104,419,3.4343675417661097
Bridgeville,150,395,247,307,503,751,1254,642,2203,3.439400817067635
Broadview Heights,88,193,121,140,266,518,784,314,1238,3.6421647819063003
Philo,3,5,5,0,10,5,15,10,25,3.2
Hudson,159,343,297,323,731,1059,1790,640,2753,3.6778060297856885
North Versailles,45,69,28,33,73,102,175,97,305,3.363934426229508
El Mirage,92,250,80,75,190,556,746,330,1151,3.627280625543006
Moon Twp,4,2,4,3,9,13,22,6,31,3.870967741935484
Leinfelden-Echterdingen,78,55,56,114,223,239,462,111,687,3.7787481804949055
Ludwigsburg,191,224,258,312,574,786,1360,482,2154,3.668523676880223
Springdale,12,8,11,9,49,127,176,19,204,4.352941176470588
Mantua,12,17,8,9,19,18,37,25,71,3.183098591549296
Copley,27,92,38,43,52,74,126,130,299,2.9264214046822743
Saint-Sauveur,47,31,29,49,80,109,189,60,298,3.6946308724832213
Westmount,76,68,71,119,233,315,548,139,806,3.8138957816377173
Aurora,258,464,312,413,873,1013,1886,776,3075,3.5395121951219513
Chateauguay,15,6,10,12,17,10,27,16,55,3.272727272727273
Stoughton,84,89,62,85,235,445,680,151,916,3.9661572052401746
Bradford,16,37,19,25,30,41,71,56,152,3.125
Ambridge,28,20,15,17,61,201,262,35,314,4.2993630573248405
Paw Creek,1,0,1,0,2,0,2,1,3,3.3333333333333335
Brooklyn,62,218,124,162,270,323,593,342,1097,3.324521422060164
Esslingen,109,90,99,161,293,402,695,189,1045,3.782775119617225
Pointe-Claire,75,82,77,141,232,207,439,159,739,3.548037889039242
Pierrefonds,34,34,14,30,68,114,182,48,260,3.8230769230769233
Litchfield,7,3,1,3,4,26,30,4,37,4.324324324324325
Saint-Laurent,107,183,118,151,298,299,597,301,1049,3.3927550047664443
Heidelberg,9,7,3,11,26,69,95,10,116,4.267241379310345
Mount Lebanon,16,26,34,48,129,213,342,60,450,4.042222222222223
Newmarket,240,335,234,387,834,977,1811,569,2767,3.680881821467293
Hemmingen,14,10,12,15,22,34,56,22,93,3.6236559139784945
Peninsula,23,53,36,63,161,219,380,89,532,3.8590225563909772
Schomberg,6,2,1,1,13,9,22,3,26,4.0
Stowe,10,27,13,13,19,24,43,40,96,3.0
Ingram,1,1,0,0,1,4,5,1,6,4.166666666666667
Musselburgh,20,9,7,20,46,49,95,16,131,3.9083969465648853
Shaker Heights,49,87,43,62,125,291,416,130,608,3.8059210526315788
Avon Lake,94,192,126,139,310,635,945,318,1402,3.7631954350927246
Mahomet,34,42,34,44,60,141,201,76,321,3.6978193146417446
Boisbriand,13,7,5,15,18,26,44,12,71,3.7183098591549295
Maple,46,74,38,82,130,125,255,112,449,3.4320712694877504
Spring Valley,8,72,47,76,261,607,868,119,1063,4.2079021636876766
Tallmadge,46,101,42,53,106,263,369,143,565,3.686725663716814
Bainbridge Township,1,3,5,2,4,0,4,8,14,2.5
Georgetown,35,30,31,36,54,106,160,61,257,3.6809338521400776
Topaz,1,0,0,2,0,17,17,0,19,4.7894736842105265
Livingston,34,20,22,32,49,40,89,42,163,3.411042944785276
Dorval,69,211,142,234,282,156,438,353,1025,3.029268292682927
Sheffield,5,9,5,3,28,49,77,14,94,4.095744680851064
Ostfildern,47,19,22,35,97,102,199,41,275,3.8763636363636365
Oakwood Village,5,15,0,2,1,12,13,15,30,2.8333333333333335
Oakdale,31,31,20,26,64,113,177,51,254,3.8188976377952755
Lachine,37,31,24,39,80,105,185,55,279,3.7311827956989245
Woodmere,57,203,241,353,761,782,1543,444,2340,3.717094017094017
Medina,236,480,310,336,736,1263,1999,790,3125,3.63744
Sheffield Village,24,46,22,38,70,71,141,68,247,3.396761133603239
University Heights,31,116,108,119,219,266,485,224,828,3.496376811594203
Dunfermline,37,20,13,23,48,53,101,33,157,3.643312101910828
North Huntingdon,41,70,34,53,119,236,355,104,512,3.814453125
McFarland,23,31,19,21,70,123,193,50,264,3.890151515151515
Braddock,9,7,2,9,28,119,147,9,165,4.515151515151516
Paradise,24,80,27,45,125,173,298,107,450,3.631111111111111
Midlothian,5,2,1,15,32,12,44,3,62,3.8225806451612905
MESA,93,482,186,172,369,1284,1653,668,2493,3.7168070597673486
Filderstadt,53,54,31,82,125,155,280,85,447,3.6621923937360177
Brooklin,6,8,4,6,14,21,35,12,53,3.6792452830188678
Carnegie,82,194,121,149,410,725,1135,315,1599,3.8449030644152598
Waxhaw,119,240,147,163,356,768,1124,387,1674,3.7556750298685784
Stuttgart Bad-Canstatt,1,0,1,0,1,1,2,1,3,3.6666666666666665
Missisauga,5,40,42,76,131,91,222,82,380,3.5026315789473683
Woodbridge,179,310,228,340,548,633,1181,538,2059,3.469159786304031
Davidson,81,214,220,304,624,1006,1630,434,2368,3.839527027027027
Carefree,77,231,159,173,326,720,1046,390,1609,3.711622125543816
West Homestead,17,108,88,110,191,165,356,196,662,3.3277945619335347
Richfield,34,70,56,60,139,161,300,126,486,3.545267489711934
Garfield Heights,36,65,26,29,45,112,157,91,277,3.407942238267148
South Euclid,68,212,107,116,196,297,493,319,928,3.279094827586207
Outremont,34,23,38,59,183,246,429,61,549,4.076502732240437
Kernen,8,5,4,10,14,17,31,9,50,3.68
Goodyear AZ,1,0,0,0,1,2,3,0,3,4.666666666666667
Moreland Hills,7,23,25,29,53,90,143,48,220,3.7363636363636363
De Forest,24,48,17,18,62,90,152,65,235,3.548936170212766
Boucherville,23,10,7,32,42,41,83,17,132,3.734848484848485
Pleasant Hills,31,82,44,52,86,165,251,126,429,3.484848484848485
Paradise Valley,112,401,328,351,858,1808,2666,729,3746,3.8926855312333157
Wickliffe,34,48,24,34,77,151,228,72,334,3.7754491017964074
LaSalle,4,1,0,2,6,7,13,1,16,4.125
Oakmont,40,65,65,86,172,312,484,130,700,3.8585714285714285
Las vegas,4,85,42,47,44,50,94,127,268,2.746268656716418
Mount Horeb,40,49,52,76,171,258,429,101,606,3.886138613861386
Totronto,1,3,0,0,0,0,0,3,3,1.0
Beloeil,7,3,5,3,10,8,18,8,29,3.5172413793103448
Brunswick,124,263,120,129,290,553,843,383,1355,3.5535055350553506
Frazer,38,88,77,96,167,254,421,165,682,3.6187683284457477
Lake Wylie,32,112,83,70,111,239,350,195,615,3.4585365853658536
White Oak,22,32,27,28,59,94,153,59,240,3.65
Belleville,14,40,11,10,22,70,92,51,153,3.4640522875816995
Bruntsfield,1,0,0,1,2,2,4,0,5,4.2
Sindelfingen,120,85,107,195,362,408,770,192,1157,3.7787381158167674
Mentor-on-the-Lake,9,17,12,13,25,104,129,29,171,4.093567251461988
Leith,9,2,6,14,50,13,63,8,85,3.776470588235294
Fairview Park,78,182,128,178,351,665,1016,310,1504,3.7905585106382977
Dalkeith,13,4,5,9,21,21,42,9,60,3.8333333333333335
Sewickley,93,172,120,136,256,470,726,292,1154,3.634315424610052
Homestead,113,383,294,494,814,786,1600,677,2771,3.478527607361963
West Mifflin,110,249,124,187,256,411,667,373,1227,3.371638141809291
San Tan Valley,76,319,85,71,100,400,500,404,975,3.1815384615384614
New Kensington,60,89,45,44,121,297,418,134,596,3.825503355704698
Gibsonia,91,145,72,126,226,383,609,217,952,3.661764705882353
Dollard-des-Ormeaux,42,36,43,67,110,115,225,79,371,3.606469002695418
Anthem,91,281,105,128,239,676,915,386,1429,3.6466060181945417
Vanier,2,0,0,2,3,2,5,0,7,4.0
Highland Heights,30,110,91,108,217,220,437,201,746,3.4638069705093835
Saint-Jean-sur-Richelieu,18,3,6,7,33,41,74,9,90,4.144444444444445
Repentigny,4,2,0,1,1,12,13,2,16,4.3125
Laveen,115,627,172,167,295,813,1108,799,2074,3.2386692381870783
Macedonia,86,258,127,141,236,358,594,385,1120,3.275892857142857
Elizabeth,23,22,10,14,37,82,119,32,165,3.890909090909091
Huntsburg,1,0,0,0,1,4,5,0,5,4.8
Longueuil,48,34,18,41,101,99,200,52,293,3.726962457337884
DeForest,17,41,28,37,83,118,201,69,307,3.6807817589576546
Upper St Clair,4,11,11,14,21,35,56,22,92,3.630434782608696
Fairlawn,119,268,206,241,471,678,1149,474,1864,3.5820815450643777
Amherst,66,138,76,76,212,328,540,214,830,3.621686746987952
Forest Hills,3,15,4,1,9,10,19,19,39,2.871794871794872
Burton,19,31,20,19,70,125,195,51,265,3.8981132075471696
Moon Township,29,70,74,96,163,238,401,144,641,3.6630265210608424
Mayfield,11,79,18,20,26,60,86,97,203,2.852216748768473
Vaudreuil-Dorion,39,15,14,26,57,85,142,29,197,3.9289340101522843
Warrensville Heights,33,143,73,85,111,203,314,216,615,3.256910569105691
WICKLIFFE,19,25,17,27,49,95,144,42,213,3.807511737089202
Munhall,21,69,35,32,53,45,98,104,234,2.871794871794872
Imperial,14,20,9,9,32,69,101,29,139,3.870503597122302
Fort McDowell,13,67,46,50,63,88,151,113,314,3.1878980891719744
Columbia Station,14,20,3,7,12,46,58,23,88,3.6931818181818183
Olmsted Township,5,9,13,6,8,12,20,22,48,3.0208333333333335
Dallas,23,28,10,12,25,72,97,38,147,3.7006802721088436
Catawba Springs,1,2,0,0,0,1,1,2,3,2.3333333333333335
South Las Vegas,6,136,114,161,287,303,590,250,1001,3.5064935064935066
Sainte-Catherine,2,0,0,1,6,4,10,0,11,4.2727272727272725
Glenshaw,37,62,35,40,78,173,251,97,388,3.6829896907216493
Aspinwall,17,19,22,17,44,93,137,41,195,3.871794871794872
Roosevelt,8,10,5,8,19,30,49,15,72,3.75
Rexdale,4,19,13,14,58,54,112,32,158,3.7278481012658227
St-Bruno-de-Montarville,1,0,0,2,2,0,2,0,4,3.5
Böblingen,121,112,98,190,375,469,844,210,1244,3.7966237942122185
Bath,3,1,6,8,9,18,27,7,42,3.880952380952381
Hawthorne,1,0,0,0,0,3,3,0,3,5.0
Candiac,3,0,0,1,4,5,9,0,10,4.4
N Las Vegas,22,61,18,14,39,154,193,79,286,3.7237762237762237
Dollard-Des-Ormeaux,59,77,84,102,208,165,373,161,636,3.4716981132075473
Robinson Township,21,94,60,74,117,170,287,154,515,3.4058252427184468
Monticello,27,22,18,26,56,107,163,40,229,3.908296943231441
Oregon,58,102,51,70,138,228,366,153,589,3.575551782682513
Brentwood,13,14,5,8,22,30,52,19,79,3.6202531645569622
Monongahela,14,20,4,11,28,57,85,24,120,3.816666666666667
Highland Hills,2,3,2,1,0,0,0,5,6,1.6666666666666667
Saint-Basile-Le-Grand,1,0,0,0,1,2,3,0,3,4.666666666666667
Fairview,20,18,9,11,49,165,214,27,252,4.325396825396825
Midland,13,2,3,6,28,57,85,5,96,4.40625
Tega Cay,22,58,54,52,148,257,405,112,569,3.8646748681898067
Moss,6,1,4,5,7,7,14,5,24,3.625
Mount Holly,36,60,28,45,88,172,260,88,393,3.72264631043257
Saint-Marc-Sur-Richelieu,1,0,0,1,1,3,4,0,5,4.4
Maple Heights,29,33,18,19,29,50,79,51,149,3.302013422818792
Camargo,1,0,0,0,0,3,3,0,3,5.0
Morgan,1,0,0,0,1,2,3,0,3,4.666666666666667
McAdenville,3,4,5,5,8,6,14,9,28,3.25
Twinsburg,98,307,150,168,307,604,911,457,1536,3.4889322916666665
Mc Murray,8,22,9,13,21,28,49,31,93,3.2580645161290325
Silver Lake,2,3,0,0,0,5,5,3,8,3.5
Windsor,13,21,13,28,47,80,127,34,189,3.804232804232804
Bolton,22,34,17,31,66,53,119,51,201,3.4328358208955225
Olivos,32,16,18,47,84,57,141,34,222,3.6666666666666665
Harmarville,3,8,2,3,7,3,10,10,23,2.782608695652174
Blue Diamond,10,42,29,54,122,166,288,71,413,3.8256658595641646
South Queensferry,13,5,9,18,31,21,52,14,84,3.642857142857143
Olmsted Falls,41,69,65,75,174,265,439,134,648,3.7731481481481484
N. Las Vegas,6,156,41,35,36,54,90,197,322,2.3509316770186337
Firth of Forth,3,1,1,1,6,10,16,2,19,4.2105263157894735
Leonberg,42,21,28,36,117,98,215,49,300,3.81
Whtiby,2,2,0,1,3,3,6,2,9,3.5555555555555554
Saint Laurent,4,1,2,10,14,8,22,3,35,3.742857142857143
Seven Hills,25,57,42,57,121,245,366,99,522,3.871647509578544
Walton Hills,3,13,5,10,18,15,33,18,61,3.278688524590164
Kleinburg,7,10,5,7,25,31,56,15,78,3.7948717948717947
Harrison City,6,6,6,8,15,42,57,12,77,4.0519480519480515
Willowdale,6,11,10,6,9,3,12,21,39,2.5641025641025643
Ridgeville,1,0,0,0,0,3,3,0,3,5.0
Indian Land,40,124,67,91,134,283,417,191,699,3.5507868383404864
New Town,6,4,20,10,12,6,18,24,52,2.923076923076923
Delson,4,1,4,3,13,16,29,5,37,4.054054054054054
Churubusco,2,0,0,0,6,6,12,0,12,4.5
Denkendorf,7,4,1,4,7,16,23,5,32,3.9375
Saint-Hyacinthe,8,1,3,4,12,9,21,4,29,3.8620689655172415
Gullane,4,0,2,2,15,6,21,2,25,4.0
Finleyville,9,8,14,8,22,40,62,22,92,3.782608695652174
Leinfelden,2,1,1,2,2,6,8,2,12,3.9166666666666665
Surprise Crossing,1,0,0,0,4,1,5,0,5,4.2
La Prairie,14,0,5,8,25,48,73,5,86,4.348837209302325
Moon,7,14,11,17,25,66,91,25,133,3.887218045112782
Caledon East,6,4,3,6,12,6,18,7,31,3.4193548387096775
Fairport Harbor,7,13,11,13,31,41,72,24,109,3.697247706422018
Sheffield Lake,12,15,7,6,14,19,33,22,61,3.2459016393442623
Sun Lakes,21,71,18,26,35,80,115,89,230,3.152173913043478
Steinenbronn,7,2,0,5,13,13,26,2,33,4.0606060606060606
Lower Burrell,12,15,12,13,12,33,45,27,85,3.4235294117647057
St-Eugène,1,0,0,0,0,4,4,0,4,5.0
Willowick,46,77,47,63,108,212,320,124,507,3.6528599605522682
Mt. Lebanon,7,35,47,51,93,90,183,82,316,3.4936708860759493
Downtown,4,9,7,10,24,24,48,16,74,3.635135135135135
Sainte-Anne-de-Bellevue,7,15,9,10,12,14,26,24,60,3.0166666666666666
Ditzingen,22,13,10,9,24,70,94,23,126,4.015873015873016
King City,11,15,11,19,50,54,104,26,149,3.785234899328859
L'ile-Perrot,5,3,2,0,10,12,22,5,27,3.962962962962963
Waunakee,67,106,74,92,157,236,393,180,665,3.5157894736842104
Mirabel,2,0,5,6,8,2,10,5,21,3.3333333333333335
Saint-Eustache,12,2,2,7,20,20,40,4,51,4.0588235294117645
Shaler Township,2,2,1,6,11,12,23,3,32,3.9375
Side Slopes,1,0,1,1,2,1,3,1,5,3.6
Port Credit,3,4,4,10,31,37,68,8,86,4.0813953488372094
Streetsville,3,3,4,2,4,5,9,7,18,3.2222222222222223
Gormley,5,5,5,4,13,18,31,10,45,3.7555555555555555
Lowell,11,24,12,17,41,83,124,36,177,3.830508474576271
Independence,106,428,349,474,849,887,1736,777,2987,3.4747238031469703
Berry,1,0,0,1,4,4,8,0,9,4.333333333333333
Wilkins Township,1,5,8,12,18,9,27,13,52,3.3461538461538463
Middleburg Hts,5,5,0,2,11,22,33,5,40,4.125
Wesley Chapel,16,58,28,48,68,135,203,86,337,3.5756676557863503
Jefferson Hills,8,12,5,7,14,7,21,17,45,2.977777777777778
Bonnyrigg,3,2,0,1,1,8,9,2,12,4.083333333333333
Mint Hill,75,139,82,133,214,313,527,221,881,3.5448354143019296
Sainte-Anne-De-Bellevue,7,3,3,5,24,37,61,6,72,4.236111111111111
Brookpark,15,40,6,10,34,51,85,46,141,3.354609929078014
Hampton Township,9,17,17,15,31,53,84,34,133,3.6466165413533833
Esslingen am Neckar,15,10,18,29,37,39,76,28,133,3.5789473684210527
Wilkinsburg,7,8,4,5,20,14,34,12,51,3.549019607843137
Grafton,10,6,4,8,27,47,74,10,92,4.141304347826087
Hochdorf,4,0,1,3,5,6,11,1,15,4.066666666666666
Caledon,17,14,19,17,47,76,123,33,173,3.878612716763006
Île des Soeurs,1,1,2,8,13,14,27,3,38,3.973684210526316
Hendserson,1,0,0,0,0,9,9,0,9,5.0
Lawrence,1,0,0,1,1,7,8,0,9,4.666666666666667
Sharpsburg,6,7,10,9,37,73,110,17,136,4.169117647058823
Library,3,9,3,9,5,12,17,12,38,3.210526315789474
Nellis AFB,9,21,11,17,12,26,38,32,87,3.1264367816091956
Middlefield,28,41,23,36,69,89,158,64,258,3.550387596899225
Charlotte (University),1,9,1,3,1,5,6,10,19,2.5789473684210527
columbia station,6,9,5,2,11,18,29,14,45,3.533333333333333
Stouffville,45,55,51,71,140,80,220,106,397,3.350125944584383
Bellevue,33,57,36,76,146,208,354,93,523,3.7877629063097515
Summerlin South,2,0,2,1,7,2,9,2,12,3.75
Neville Island,2,4,4,4,12,4,16,8,28,3.2857142857142856
Pencaitland,1,0,0,1,5,3,8,0,9,4.222222222222222
Sainte-Adèle,2,2,1,1,8,5,13,3,17,3.764705882352941
Beaconsfield,8,2,13,5,14,23,37,15,57,3.754385964912281
Neuhausen,9,3,2,13,17,25,42,5,60,3.9833333333333334
Shadyside,3,5,5,7,12,31,43,10,60,3.9833333333333334
Saint-Lambert,20,6,4,9,32,54,86,10,105,4.180952380952381
Burntisland,2,0,1,0,3,2,5,1,6,4.0
Montral,1,4,2,2,1,1,2,6,10,2.3
Saint Joseph,13,11,6,8,23,32,55,17,80,3.7375
Clarkson,1,2,1,3,4,1,5,3,11,3.090909090909091
Waddell,11,30,8,16,39,107,146,38,200,3.925
Piedmont,3,1,1,2,6,3,9,2,13,3.6923076923076925
Fox Chapel,1,1,0,1,3,1,4,1,6,3.5
St-Leonard,2,1,1,1,4,3,7,2,10,3.7
Cramerton,11,13,13,18,71,193,264,26,308,4.357142857142857
Gilbert AZ,1,3,0,0,0,3,3,3,6,3.0
Lowesville,2,0,1,5,6,14,20,1,26,4.269230769230769
Kirkland,29,25,13,42,56,53,109,38,189,3.5238095238095237
Mont-Saint-Hilaire,7,1,6,8,10,6,16,7,31,3.4516129032258065
Munroe Falls,14,11,8,13,33,99,132,19,164,4.225609756097561
Ingomar,2,1,0,0,2,3,5,1,6,4.0
Mont-Royal,16,18,13,23,65,38,103,31,157,3.5859872611464967
Swissvale,6,7,4,3,12,21,33,11,47,3.765957446808511
Baldwin,2,7,4,5,8,8,16,11,32,3.1875
Novelty,3,0,0,0,0,10,10,0,10,5.0
Bedford Heights,17,33,12,9,26,84,110,45,164,3.707317073170732
Gerlingen,25,6,14,29,49,57,106,20,155,3.8838709677419354
Malton,1,4,0,2,0,0,0,4,6,1.6666666666666667
Bainbridge,9,7,1,8,29,59,88,8,104,4.269230769230769
Youngtown,43,125,25,28,42,383,425,150,603,3.8839137645107793
Mc Donald,2,0,2,3,4,2,6,2,11,3.5454545454545454
Dormont,6,1,1,10,20,45,65,2,77,4.3896103896103895
Cecil,7,9,4,9,44,127,171,13,193,4.430051813471502
Rantoul,35,59,25,31,58,97,155,84,270,3.403703703703704
St. Jean Sur Richelieu,1,0,0,0,3,0,3,0,3,4.0
Pepper Pike,18,40,20,38,80,158,238,60,336,3.880952380952381
Weddington,6,3,7,12,6,38,44,10,66,4.045454545454546
Sagamore Hills,6,10,5,3,5,16,21,15,39,3.3076923076923075
Nobleton,4,12,4,1,8,18,26,16,43,3.372093023255814
Buckeye - Shaker,1,2,1,0,2,2,4,3,7,3.142857142857143
Turtle Creek,15,28,7,12,38,65,103,35,150,3.7
Downsview,3,4,2,7,5,11,16,6,29,3.586206896551724
West View,12,7,3,10,38,101,139,10,159,4.40251572327044
Rouses Point,6,3,4,13,15,15,30,7,50,3.7
Houston,7,13,12,6,22,20,42,25,73,3.328767123287671
Guadalupe,20,44,23,43,81,175,256,67,366,3.8743169398907105
Willoughby Hills,37,61,34,41,126,211,337,95,473,3.828752642706131
Creighton,2,2,1,1,3,4,7,3,11,3.5454545454545454
Loanhead,7,3,3,2,16,7,23,6,31,3.6774193548387095
Robinson,9,25,24,20,49,70,119,49,188,3.6117021276595747
St. Joseph,1,0,0,0,0,3,3,0,3,5.0
Vimont,3,1,3,5,16,9,25,4,34,3.8529411764705883
Mount Albert,6,0,0,4,13,22,35,0,39,4.461538461538462
Cheswick,18,19,6,14,26,43,69,25,108,3.6296296296296298
Cuyahoga Heights,1,0,0,0,3,14,17,0,17,4.823529411764706
Saint Leonard,1,0,0,2,1,0,1,0,3,3.3333333333333335
oakville,1,1,0,0,1,1,2,1,3,3.3333333333333335
McMurry,3,0,0,1,4,6,10,0,11,4.454545454545454
Lagrange,6,5,2,2,9,13,22,7,31,3.7419354838709675
Nellis Afb,8,11,2,4,28,31,59,13,76,3.8684210526315788
Mayfield Village,10,26,20,27,67,81,148,46,221,3.7104072398190047
Châteauguay,4,4,1,0,9,6,15,5,20,3.6
Murrysville (Monroeville),1,2,0,0,1,5,6,2,8,3.875
Pitcairn,4,5,1,1,0,9,9,6,16,3.4375
Nellis Air Force Base,2,3,0,0,2,3,5,3,8,3.25
Shaker Hts,1,1,0,2,3,2,5,1,8,3.625
Lothian,1,0,2,0,2,0,2,2,4,3.0
Beeton,4,0,0,2,11,12,23,0,25,4.4
Ahwatukee,16,77,55,83,182,377,559,132,774,3.9392764857881137
Ballantyne,1,2,0,2,2,7,9,2,13,3.923076923076923
Newbridge,3,3,4,2,11,15,26,7,35,3.8857142857142857
Clinton,2,1,0,2,1,15,16,1,19,4.526315789473684
Terrebonne,11,3,2,6,19,19,38,5,49,4.0
South Gyle,1,1,3,2,0,0,0,4,6,2.1666666666666665
Quartermile,1,1,2,4,6,1,7,3,14,3.2857142857142856
Higley,20,156,29,19,66,133,199,185,403,2.977667493796526
Shorewood Hills,2,8,3,12,3,9,12,11,35,3.057142857142857
East McKeesport,2,2,2,0,2,8,10,4,14,3.857142857142857
East Mc Keesport,3,2,1,3,6,9,15,3,21,3.9047619047619047
St Davids,3,1,4,3,19,27,46,5,54,4.2407407407407405
South Park Township,6,13,6,9,16,48,64,19,92,3.869565217391304
Saint-Bruno-de-Montarville,4,0,2,2,5,5,10,2,14,3.9285714285714284
Cote Saint-Luc,5,3,1,3,7,4,11,4,18,3.4444444444444446
Saint-Pierre-de-Véronne-à-Pike-River,1,0,0,0,1,2,3,0,3,4.666666666666667
Chambly,10,5,3,6,19,22,41,8,55,3.909090909090909
L'Île-Bizard,1,0,1,1,0,10,10,1,12,4.583333333333333
Bradford West Gwillimbury,16,15,7,12,21,62,83,22,117,3.923076923076923
Morin-Heights,4,3,4,1,4,7,11,7,19,3.4210526315789473
La Salle,5,3,0,2,11,9,20,3,25,3.92
Mt. Horeb,1,0,0,0,0,11,11,0,11,5.0
Rigaud,3,4,3,6,8,9,17,7,30,3.5
Saint-Constant,3,2,0,1,4,10,14,2,17,4.176470588235294
Boston Heights,2,1,1,2,1,12,13,2,17,4.294117647058823
Henderston,1,11,4,1,0,33,33,15,49,3.816326530612245
Freyburg,9,4,1,8,8,31,39,5,52,4.173076923076923
Mattews,1,2,1,1,1,1,2,3,6,2.6666666666666665
North Scottsdale,3,26,19,26,43,76,119,45,190,3.6526315789473682
Fountainbridge,1,1,2,4,1,0,1,3,8,2.625
Rosemère,7,3,4,7,13,13,26,7,40,3.725
Old Scottsdale,1,0,0,0,1,2,3,0,3,4.666666666666667
East Pittsburgh,5,4,4,3,5,17,22,8,33,3.8181818181818183
Remseck am Neckar,3,0,2,3,8,8,16,2,21,4.0476190476190474
Dalgety Bay,1,0,0,0,1,2,3,0,3,4.666666666666667
South Park,6,23,10,6,17,27,44,33,83,3.180722891566265
Etna,8,30,11,11,27,30,57,41,109,3.146788990825688
Mayfield Hts.,1,1,0,1,1,1,2,1,4,3.25
Saint-Lazare,3,1,6,0,9,10,19,7,26,3.8076923076923075
Chander,1,1,0,0,1,3,4,1,5,4.0
King,5,5,0,7,13,7,20,5,32,3.53125
Glendale Az,1,13,7,4,18,32,50,20,74,3.6621621621621623
Blawnox,3,4,2,4,11,9,20,6,30,3.6333333333333333
Saint-Jerome,15,5,4,9,23,22,45,9,63,3.8412698412698414
Sainte-Genevieve,2,3,0,0,4,3,7,3,10,3.4
Nottingham,6,6,2,5,35,86,121,8,134,4.440298507462686
Lake Park,1,2,1,1,1,1,2,3,6,2.6666666666666665
Squirrel Hill,3,1,6,4,10,14,24,7,35,3.857142857142857
Glassport,5,2,1,4,1,16,17,3,24,4.166666666666667
City of Edinburgh,4,3,1,4,9,2,11,4,19,3.3157894736842106
East Cleveland,4,4,0,3,6,4,10,4,17,3.3529411764705883
Lasswade,4,5,5,6,17,10,27,10,43,3.511627906976744
Brookline,2,10,9,13,22,19,41,19,73,3.4246575342465753
Phoenix AZ,1,2,0,0,0,2,2,2,4,3.0
peoria,2,2,0,0,0,12,12,2,14,4.428571428571429
St Bernard de Lacolle,1,0,1,2,1,0,1,1,4,3.0
Aberdour,1,0,0,1,3,0,3,0,4,3.75
Newbury,15,25,14,19,37,51,88,39,146,3.5136986301369864
Ft. Mill,2,32,16,9,8,15,23,48,80,2.475
Anjou,12,14,10,20,25,17,42,24,86,3.244186046511628
Las  Vegas,5,21,11,20,54,208,262,32,314,4.328025477707007
St-Lazare-de-Vaudreuil,1,0,0,1,0,3,3,0,4,4.5
The Promenade,1,2,0,0,0,3,3,2,5,3.4
Cross Plains,19,112,14,29,45,74,119,126,274,2.835766423357664
TORONTO,2,2,1,0,1,4,5,3,8,3.5
Bedford Hts.,1,1,0,1,3,2,5,1,7,3.7142857142857144
Northfield Center Township,1,1,2,1,2,4,6,3,10,3.6
Crafton,9,34,8,15,23,42,65,42,122,3.2540983606557377
Centre Island,1,0,0,2,1,1,2,0,4,3.75
Geauga,2,0,1,1,4,6,10,1,12,4.25
Strongville,1,2,1,0,2,1,3,3,6,2.8333333333333335
Rankin,2,6,0,0,0,4,4,6,10,2.6
London,1,1,1,0,2,0,2,2,4,2.75
"Phoenix,",1,1,0,0,3,22,25,1,26,4.730769230769231
Wilmerding,7,8,4,6,13,21,34,12,52,3.673076923076923
NORTH YORK,2,1,2,5,11,7,18,3,26,3.8076923076923075
etobicoke,2,4,1,0,0,3,3,5,8,2.625
Homer,4,0,0,2,4,14,18,0,20,4.6
Ingliston,3,3,0,2,3,1,4,3,9,2.888888888888889
Bellvue,3,2,1,3,7,11,18,3,24,4.0
Upper St. Clair,4,2,4,8,6,8,14,6,28,3.5
Newington,2,0,4,0,2,4,6,4,10,3.6
Orange Village,3,22,22,33,125,216,341,44,418,4.1746411483253585
Leetsdale,8,26,22,18,45,50,95,48,161,3.440993788819876
Thorncliffe Park,1,2,2,1,6,0,6,4,11,3.0
Robinson Town,1,7,2,2,0,0,0,9,11,1.5454545454545454
Penicuik,13,5,7,17,20,8,28,12,57,3.3333333333333335
Pilton,1,0,0,0,0,4,4,0,4,5.0
Chatauguay,1,0,0,1,1,2,3,0,4,4.25
Summerlin,6,17,5,10,8,49,57,22,89,3.752808988764045
Korntal-Münchingen,12,3,2,11,16,21,37,5,53,3.943396226415094
Oka,3,3,0,0,8,5,13,3,16,3.75
Montreal-West,3,3,0,1,7,10,17,3,21,4.0
Las Vegas Strip,1,8,0,0,1,6,7,8,15,2.8
Juniper Green,2,1,1,2,1,8,9,2,13,4.076923076923077
"Las Vegas, NV",1,0,1,2,4,1,5,1,8,3.625
Ste-Adele,1,0,0,1,2,0,2,0,3,3.6666666666666665
McKnight,2,6,1,2,3,10,13,7,22,3.4545454545454546
Richmond Hts,4,3,0,1,7,17,24,3,28,4.25
Schwieberdingen,8,4,3,3,13,24,37,7,47,4.0638297872340425
Herminie,3,1,1,0,3,17,20,2,22,4.545454545454546
Prestonpans,3,1,0,0,3,5,8,1,9,4.222222222222222
Dollard-Des Ormeaux,2,7,4,5,13,12,25,11,41,3.4634146341463414
Haddington,6,0,1,6,8,3,11,1,18,3.7222222222222223
Scottdale,5,42,32,43,116,256,372,74,489,4.047034764826176
mesa,1,29,1,0,0,9,9,30,39,1.9487179487179487
Ross Township,6,15,16,45,63,59,122,31,198,3.6818181818181817
South Hills,1,0,0,0,4,2,6,0,6,4.333333333333333
Montreal-Nord,3,3,1,5,9,17,26,4,35,4.0285714285714285
L'Île-Perrôt,1,0,0,0,5,4,9,0,9,4.444444444444445
Fabreville,1,0,1,2,1,7,8,1,11,4.2727272727272725
FORT MILL,1,0,0,0,0,3,3,0,3,5.0
Broadlands,1,0,0,0,0,4,4,0,4,5.0
Median,1,5,0,0,1,8,9,5,14,3.5
Mayfield Hts,1,1,0,0,1,1,2,1,3,3.3333333333333335
Kirtland,13,14,8,18,37,136,173,22,213,4.28169014084507
Henderson and Las vegas,1,0,1,1,3,3,6,1,8,4.0
Centennial Hills,1,12,4,5,7,14,21,16,42,3.1666666666666665
Ratho,1,1,2,2,9,7,16,3,21,3.9047619047619047
Noyan,2,0,0,1,0,8,8,0,9,4.777777777777778
Venetia,3,3,1,4,11,21,32,4,40,4.15
Clark,5,23,18,25,51,117,168,41,234,3.9444444444444446
Mansfield,2,0,0,0,2,4,6,0,6,4.666666666666667
Montréal-Nord,1,1,3,3,3,10,13,4,20,3.9
Salaberry-De-Valleyfield,4,1,0,3,4,8,12,1,16,4.125
Berg,2,0,0,1,1,5,6,0,7,4.571428571428571
Sainte-Adele,5,1,2,3,6,8,14,3,20,3.9
L'ile-Bizard,2,0,1,1,1,4,5,1,7,4.142857142857143
Nord,1,0,0,1,3,7,10,0,11,4.545454545454546
Longniddry,1,0,1,0,1,1,2,1,3,3.6666666666666665
Gifford,2,2,1,1,6,1,7,3,11,3.272727272727273
Orange,4,12,5,4,9,13,22,17,43,3.13953488372093
,3,2,3,3,6,2,8,5,16,3.1875
North of Brampton,1,0,3,1,9,3,12,3,16,3.75
Sidney,1,1,1,1,2,14,16,2,19,4.421052631578948
Montreal-Ouest,2,10,7,5,24,10,34,17,56,3.3035714285714284
Shady Side,1,0,0,0,0,6,6,0,6,5.0
"Phoenix, AZ",1,5,2,1,2,9,11,7,19,3.4210526315789473
Mesa Arizona,1,0,0,0,0,6,6,0,6,5.0
Arrowhead,1,4,0,0,0,4,4,4,8,3.0
Pointe-Aux-Trembles,3,0,0,3,5,2,7,0,10,3.9
Harrisbug,1,4,4,3,7,11,18,8,29,3.586206896551724
Chateau,1,0,0,0,0,3,3,0,3,5.0
Clairton,12,22,8,12,39,46,85,30,127,3.622047244094488
Scaroborough,1,4,5,6,22,7,29,9,44,3.522727272727273
Champlain,5,28,3,3,2,9,11,31,45,2.1333333333333333
Farnham,1,0,0,0,2,1,3,0,3,4.333333333333333
Saint-Jean-Sur-Richelieu,3,1,0,2,5,10,15,1,18,4.277777777777778
East Mesa,1,0,0,0,0,8,8,0,8,5.0
Sainte-Therese,5,0,1,2,4,17,21,1,24,4.541666666666667
Arnold,4,6,3,1,10,47,57,9,67,4.3283582089552235
Balerno,1,2,0,0,1,0,1,2,3,2.0
Greenfield Park,9,4,10,16,24,25,49,14,79,3.7088607594936707
Hazelwood,1,0,0,0,3,2,5,0,5,4.4
Peoria Ave Citizen's Group,1,0,0,0,0,4,4,0,4,5.0
Old Brooklyn,1,0,0,0,0,4,4,0,4,5.0
Edgewood,2,3,0,2,4,13,17,3,22,4.090909090909091
Weston,1,2,0,0,0,1,1,2,3,2.3333333333333335
Cuddy,2,1,0,3,1,3,4,1,8,3.625
Saint-Antoine,1,0,0,1,1,4,5,0,6,4.5
toronto,4,8,7,13,17,12,29,15,57,3.3157894736842106
St-Jerome,1,3,6,2,3,3,6,9,17,2.823529411764706
Sunnyslope,1,0,0,0,0,12,12,0,12,5.0
Sainte-Dorothée,1,2,0,1,0,1,1,2,4,2.5
NorthYork,1,0,0,3,0,0,0,0,3,3.0
Phoneix,2,2,0,0,0,8,8,2,10,4.2
Linden,2,2,2,0,1,3,4,4,8,3.125
Kernen im Remstal,3,1,0,2,7,9,16,1,19,4.2105263157894735
Crescent,1,1,0,1,1,3,4,1,6,3.8333333333333335
Thornhil,1,0,0,3,4,6,10,0,13,4.230769230769231
Black Earth,6,8,4,3,22,38,60,12,75,4.04
Warrensville Hts.,1,7,2,3,11,9,20,9,32,3.40625
University Hts ,1,7,0,0,0,4,4,7,11,2.4545454545454546
Sun City Anthem,1,6,2,0,0,4,4,8,12,2.5
Bedford HTS,1,1,0,1,7,9,16,1,18,4.277777777777778
Mentor On the,5,3,4,7,4,15,19,7,33,3.727272727272727
Möglingen,5,1,2,2,10,10,20,3,25,4.04
L'Ile-Perrot,1,1,0,0,1,2,3,1,4,3.75
McCandless,5,4,5,6,4,26,30,9,45,3.9555555555555557
Sainte-Thérèse,3,0,1,1,8,2,10,1,12,3.9166666666666665
Mount Washington,1,1,0,4,11,6,17,1,22,3.9545454545454546
Pheonix,4,9,15,28,45,23,68,24,120,3.4833333333333334
Baie-d'Urfé,1,0,0,1,1,1,2,0,3,4.0
Bernhausen,1,2,2,3,13,14,27,4,34,4.029411764705882
Saint-Hippolyte,1,1,0,2,0,2,2,1,5,3.4
Troy Township,1,3,0,2,3,2,5,3,10,3.1
Leslieville,1,0,0,0,1,2,3,0,3,4.666666666666667
Rainbow Valley,1,0,0,0,0,3,3,0,3,5.0
Remseck,6,3,9,14,13,10,23,12,49,3.36734693877551
N Ridgeville,2,5,2,2,0,4,4,7,13,2.6923076923076925
Mentor On the Lake,7,6,3,7,9,20,29,9,45,3.7555555555555555
Wildwood,2,5,1,2,9,4,13,6,21,3.2857142857142856
Deux-Montagnes Regional County Municipality,1,1,0,0,1,2,3,1,4,3.75
Lauder,2,0,0,0,4,2,6,0,6,4.333333333333333
Schottsdale,1,0,3,0,1,1,2,3,5,3.0
River Drive Park,1,0,0,2,1,6,7,0,9,4.444444444444445
Glenrothes,6,4,2,9,9,7,16,6,31,3.4193548387096775
Gorebridge,2,3,0,1,1,5,6,3,10,3.5
Edgeworth,1,0,0,0,0,3,3,0,3,5.0
"Toronto, Ontario",1,0,1,0,3,10,13,1,14,4.571428571428571
Statesville,1,0,0,0,0,3,3,0,3,5.0
Sainte-Marguerite-du-Lac-Masson,1,1,0,0,1,2,3,1,4,3.75
L'Île-Perrot,4,10,2,14,41,70,111,12,137,4.160583941605839
Emsworth,3,4,7,4,21,39,60,11,75,4.12
Lachenaie,2,0,2,2,4,0,4,2,8,3.25
Avalon,7,10,5,11,12,34,46,15,72,3.763888888888889
Saint - Hyacinthe,1,0,0,0,2,3,5,0,5,4.6
Joliette,4,1,1,1,5,6,11,2,14,4.0
N. Olmsted,1,11,7,9,10,11,21,18,48,3.0625
Queensferry,5,0,2,5,9,15,24,2,31,4.193548387096774
Pheonix AZ,1,1,2,1,3,4,7,3,11,3.6363636363636362
Central City Village,3,11,6,5,5,10,15,17,37,2.918918918918919
Aberlady,2,0,0,2,2,3,5,0,7,4.142857142857143
Stoney Creek,2,5,3,3,1,5,6,8,17,2.8823529411764706
Kahnawake,3,2,0,1,5,8,13,2,16,4.0625
Estérel,1,1,3,2,2,5,7,4,13,3.5384615384615383
Old Town Scottsdale,1,0,1,0,0,2,2,1,3,4.0
Rawdon,3,0,2,2,2,6,8,2,12,4.0
Cuyahoga Fls,2,2,0,3,2,2,4,2,9,3.2222222222222223
Desert Ridge,1,1,0,1,1,4,5,1,7,4.0
Pittsburg,4,9,0,1,4,17,21,9,31,3.6451612903225805
Downtown Toronto,3,3,1,1,3,5,8,4,13,3.4615384615384617
Grand River,2,43,25,30,47,51,98,68,196,3.193877551020408
Northside,1,0,2,0,3,2,5,2,7,3.7142857142857144
Roxboro,1,1,2,0,4,3,7,3,10,3.6
Saint Anns,1,2,0,1,0,5,5,2,8,3.75
Russell Twp,1,3,1,0,2,4,6,4,10,3.3
Monoroeville,2,6,0,1,0,13,13,6,20,3.7
Napierville,1,0,0,1,2,1,3,0,4,4.0
Cowdenbeath,1,3,0,0,0,0,0,3,3,1.0
Ranlo,1,0,0,2,3,13,16,0,18,4.611111111111111
Buena Vista,2,1,1,2,1,2,3,2,7,3.2857142857142856
tempe arizona,1,1,0,0,0,3,3,1,4,4.0
Bratenahl,2,2,1,4,11,24,35,3,42,4.285714285714286
Upper Saint Clair,4,24,17,21,38,26,64,41,126,3.1984126984126986
Blainville,4,1,1,3,2,15,17,2,22,4.318181818181818
Île-des-Soeurs,1,0,0,2,1,0,1,0,3,3.3333333333333335
Lachute,2,0,0,2,5,4,9,0,11,4.181818181818182
McDonald,2,4,1,1,3,20,23,5,29,4.172413793103448
Sainte-Madeleine,1,0,0,2,0,1,1,0,3,3.6666666666666665
Sainte-Anne-des-Plaines,1,0,2,4,2,0,2,2,8,3.0
McCandless Township,6,12,10,5,36,42,78,22,105,3.8190476190476192
"Indian Land,",1,0,0,2,0,1,1,0,3,3.6666666666666665
Mooers,1,0,0,0,0,3,3,0,3,5.0
N E Las Vegas,1,1,2,1,1,9,10,3,14,4.071428571428571
Saint-Sauveur-des-Monts,2,2,1,4,0,2,2,3,9,2.888888888888889
La Baie,3,1,1,2,3,3,6,2,10,3.6
Mccandless Township,1,0,0,0,1,3,4,0,4,4.75
Alburg,1,0,0,0,0,5,5,0,5,5.0
Sloan,1,5,1,12,67,129,196,6,214,4.4672897196261685
Warrensvile Heights,1,2,4,1,2,3,5,6,12,3.0
Oakland,4,9,11,27,19,10,29,20,76,3.1315789473684212
Phoenix Valley,1,3,0,0,0,0,0,3,3,1.0
Concord Twp,1,0,0,1,2,2,4,0,5,4.2
North Huntington,2,5,4,3,1,9,10,9,22,3.227272727272727
Leven,1,1,2,0,1,2,3,3,6,3.1666666666666665
North Olmstead,2,13,8,4,6,6,12,21,37,2.5675675675675675
Vaudreuil,1,0,0,0,1,2,3,0,3,4.666666666666667
Mt Lebanon,5,8,1,1,17,56,73,9,83,4.349397590361446
East Gwilimbury,1,1,0,2,2,0,2,1,5,3.0
Central Henderson,1,9,4,6,3,8,11,13,30,2.9
Fort  Mill,1,9,16,10,12,12,24,25,59,3.0338983050847457
Mcmurray,2,4,1,0,2,7,9,5,14,3.5
North Toronto,1,3,5,7,6,2,8,8,23,2.9565217391304346
Dudley,2,0,0,3,1,2,3,0,6,3.8333333333333335
Liberty,1,1,1,1,1,5,6,2,9,3.888888888888889
Northfield Center,1,2,1,1,1,7,8,3,12,3.8333333333333335
Norval,1,3,0,0,2,1,3,3,6,2.6666666666666665
Portobello,1,0,0,0,3,0,3,0,3,4.0
Old Port of Montreal,1,0,0,1,2,0,2,0,3,3.6666666666666665
Mercier,2,0,1,1,3,6,9,1,11,4.2727272727272725
AGINCOURT,1,1,3,1,1,0,1,4,6,2.3333333333333335
Mesa AZ,1,2,0,0,3,2,5,2,7,3.4285714285714284
Vaughn,1,0,0,0,0,5,5,0,5,5.0
Ashburn,1,1,0,0,2,6,8,1,9,4.333333333333333
Plieningen,1,0,1,2,1,3,4,1,7,3.857142857142857
North Braddock,1,1,0,0,0,2,2,1,3,3.6666666666666665
Saint-Bruno,2,0,0,1,4,3,7,0,8,4.25
Le Sud-Ouest,1,0,0,1,4,10,14,0,15,4.6
Bradfordwoods,1,2,0,0,1,5,6,2,8,3.875
Paoli,3,6,2,2,11,34,45,8,55,4.181818181818182
Presto,3,4,2,5,17,42,59,6,70,4.3
Goodwood,2,2,0,1,10,7,17,2,20,4.0
Pepperpike,1,1,0,0,2,1,3,1,4,3.5
CHARLOTTE,1,0,0,0,0,3,3,0,3,5.0
Montréal (Québec),1,0,0,1,1,3,4,0,5,4.4
Montréal-Ouest,1,0,2,0,3,1,4,2,6,3.5
Arlington,2,1,0,0,0,6,6,1,7,4.428571428571429
Mont-Saint-Gregoire,4,1,1,8,10,6,16,2,26,3.730769230769231
West Lothian,1,0,0,0,0,3,3,0,3,5.0
Pgh Int Arprt,1,1,0,0,1,1,2,1,3,3.3333333333333335
Schwaikheim,3,2,0,1,4,6,10,2,13,3.923076923076923
San Rafael,1,183,8,4,9,5,14,191,209,1.3014354066985645
Lingen,1,1,0,0,1,3,4,1,5,4.0
Hemmingford,1,0,0,2,1,0,1,0,3,3.3333333333333335
West Akron,1,4,4,7,19,44,63,8,78,4.217948717948718
Regent Square,1,1,0,1,3,2,5,1,7,3.7142857142857144
Reminderville,1,1,0,2,0,4,4,1,7,3.857142857142857
Chandler-Gilbert,1,0,0,0,0,9,9,0,9,5.0
Tranent,2,1,0,5,0,0,0,1,6,2.6666666666666665
Oak Ridges,1,2,1,0,1,4,5,3,8,3.5
Concord Township,1,0,0,0,0,3,3,0,3,5.0
CITY CENTER,1,1,0,0,0,27,27,1,28,4.857142857142857
Dane,3,0,0,0,6,10,16,0,16,4.625
Queensville,1,0,1,2,0,0,0,1,3,2.6666666666666665
Ross,2,0,0,0,5,4,9,0,9,4.444444444444445
Strip District,1,1,0,0,0,2,2,1,3,3.6666666666666665
Wolfschlugen,1,0,1,0,0,2,2,1,3,4.0
Cleveland Hghts.,1,2,2,5,10,5,15,4,24,3.5833333333333335
East Lothian,3,0,0,0,7,5,12,0,12,4.416666666666667
Communauté-Urbaine-de-Montréal,2,1,0,1,6,7,13,1,15,4.2
Phoniex,1,1,0,0,1,1,2,1,3,3.3333333333333335
Don Mills,3,5,8,10,44,37,81,13,104,3.9615384615384617
West Toronto,1,1,0,0,2,3,5,1,6,4.0
Pincourt,1,1,1,0,0,6,6,2,8,4.125
Franklin Park,2,3,3,1,1,7,8,6,15,3.4
New Eagle,3,2,0,3,5,12,17,2,22,4.136363636363637
Lower Lawrenceville,1,6,40,49,99,60,159,46,254,3.65748031496063
Morriston,1,0,0,0,0,3,3,0,3,5.0
Springfield,1,0,0,0,0,3,3,0,3,5.0
Mississuaga,1,0,1,0,7,2,9,1,10,4.0
Brimfield,1,3,6,2,7,5,12,9,23,3.217391304347826
Tottenham,1,2,0,0,3,5,8,2,10,3.9
West Elizabeth,1,0,0,0,1,3,4,0,4,4.75
Stockbridge,4,3,0,5,13,49,62,3,70,4.5
Saint-Marc-sur-Richelieu,1,0,0,1,4,1,5,0,6,4.0
Glen Williams,1,2,1,0,2,5,7,3,10,3.7
MC Murray,1,0,3,1,1,3,4,3,8,3.5
Vaughn City,1,0,0,0,1,2,3,0,3,4.666666666666667
Ste-Rose,1,1,1,0,6,10,16,2,18,4.277777777777778
Whitney,1,0,0,0,2,4,6,0,6,4.666666666666667
Gelndale,1,2,0,4,0,3,3,2,9,3.2222222222222223
Maple Grove,1,0,0,0,2,1,3,0,3,4.333333333333333
N. Ridgeville,1,6,1,1,0,0,0,7,8,1.375
Currie,1,0,0,1,2,1,3,0,4,4.0
Charlote,1,1,0,0,0,4,4,1,5,4.2
Sainte-Thérèse-de-Blainville,1,0,0,0,0,4,4,0,4,5.0
Sainte-Marie,1,0,0,0,0,3,3,0,3,5.0
Kirknewton,1,0,0,0,2,6,8,0,8,4.75
Mississauaga,1,0,0,0,0,3,3,0,3,5.0
Tremont,2,18,22,31,63,128,191,40,262,3.99618320610687
Elk Grove Villa,3,18,5,10,5,10,15,23,48,2.6666666666666665
Sunrise,1,17,1,4,3,4,7,18,29,2.1724137931034484
Robinson Twp.,1,3,3,10,14,51,65,6,81,4.320987654320987
Fullerton,1,2,0,0,4,5,9,2,11,3.909090909090909
St-Lazare,1,0,0,0,1,2,3,0,3,4.666666666666667
Pine,1,2,2,3,2,4,6,4,13,3.3076923076923075
N W Las Vegas,1,22,1,5,14,6,20,23,48,2.6041666666666665
Westworld Scottsdale,1,1,1,2,1,1,2,2,6,3.0
Saint-Isidore-De-Laprairie,1,0,0,2,0,1,1,0,3,3.6666666666666665
Roslin,1,0,0,1,2,5,7,0,8,4.5
Claremont,1,1,0,1,1,1,2,1,4,3.25
Las Vegass,1,1,0,0,0,4,4,1,5,4.2
Forest Grove,1,0,0,0,0,4,4,0,4,5.0
Elrama,1,0,0,1,6,14,20,0,21,4.619047619047619
Saint-Henri,1,3,3,3,8,7,15,6,24,3.5416666666666665
Ogden,3,3,1,1,5,10,15,4,20,3.9
Le Haut-Saint-Laurent Regional County Municipality,1,1,0,1,1,0,1,1,3,2.6666666666666665
Brooklyn Heights,2,0,1,0,0,5,5,1,6,4.5
Canonsburd,1,6,0,0,0,0,0,6,6,1.0
Regional Municipality of York,1,2,0,1,2,11,13,2,16,4.25
Saint-Jérôme,5,2,3,4,8,9,17,5,26,3.730769230769231
Duquesne,2,1,1,0,1,3,4,2,6,3.6666666666666665
"North Olmsted,",1,0,0,0,0,6,6,0,6,5.0
Auburn Township,1,1,0,1,1,16,17,1,19,4.631578947368421
Hiram,3,2,0,2,7,8,15,2,19,4.0
Lake Las Vegas,1,4,0,0,0,1,1,4,5,1.8
clinton,4,7,4,4,7,13,20,11,35,3.4285714285714284
Westview,1,0,1,0,1,2,3,1,4,4.0
Kennedy Township,2,2,1,1,4,10,14,3,18,4.055555555555555
Ansnorveldt,1,0,0,0,3,4,7,0,7,4.571428571428571
Gates Mills,2,2,8,5,13,28,41,10,56,4.017857142857143
Leaside,1,0,0,0,0,4,4,0,4,5.0
Pointe Claire,2,0,1,4,7,1,8,1,13,3.6153846153846154
Greater Charlotte,1,0,0,0,0,6,6,0,6,5.0
Ben Avon,1,1,0,6,15,24,39,1,46,4.326086956521739
Prévost,2,0,1,1,3,1,4,1,6,3.6666666666666665
Saint-Bernard-De-Lacolle,1,0,2,8,6,1,7,2,17,3.3529411764705883
Bathurst Quay,1,0,0,0,6,6,12,0,12,4.5
Monreoville,1,1,0,0,0,7,7,1,8,4.5
Scotesdale,1,0,0,0,1,3,4,0,4,4.75
Mint  Hill,1,7,2,8,14,21,35,9,52,3.769230769230769
St-Benoît de Mirabel,1,2,3,4,16,27,43,5,52,4.211538461538462
Notre-Dame-De-L'ile-Perrot,2,1,5,2,3,7,10,6,18,3.5555555555555554
Mayfield Heights.,1,0,1,0,0,4,4,1,5,4.4
Godmanchester,1,0,0,0,0,3,3,0,3,5.0
Point Claire,1,0,0,0,0,4,4,0,4,5.0
Henderson Nevada,1,0,0,0,0,3,3,0,3,5.0
Hendersonville,1,1,1,1,7,3,10,2,13,3.769230769230769
Rillton,1,0,0,0,1,5,6,0,6,4.833333333333333
L'assomption,1,0,0,0,2,2,4,0,4,4.5
Las Vegas NV,1,0,0,0,0,8,8,0,8,5.0
Mayfield Heights (Cleveland),1,2,0,0,0,19,19,2,21,4.619047619047619
Montéal,1,2,1,2,2,1,3,3,8,2.875
Russell,1,0,0,0,1,3,4,0,4,4.75
Stuttgart - Bad Cannstatt,1,2,0,1,1,1,2,2,5,2.8
Woodmere Village,1,28,22,43,63,86,149,50,242,3.6487603305785123
Warrensville Hts,2,4,0,0,1,5,6,4,10,3.3
Livingstone,1,2,0,1,0,0,0,2,3,1.6666666666666667
Saint-sauveur,1,0,1,2,0,1,1,1,4,3.25
"Chomedey, Laval",1,1,0,1,0,1,1,1,3,3.0
Henderson (Green Valley),1,14,5,2,1,7,8,19,29,2.3793103448275863
Green Tree,1,6,7,17,29,27,56,13,86,3.744186046511628
Peters Township,2,7,12,8,9,18,27,19,54,3.3518518518518516
Southside Flats,1,0,0,0,1,3,4,0,4,4.75
Meza,1,20,0,0,1,2,3,20,23,1.4782608695652173
Elizabeth Township,1,7,3,0,10,6,16,10,26,3.1923076923076925
Vilas,1,1,0,0,1,2,3,1,4,3.75
Shaler,1,1,0,0,0,2,2,1,3,3.6666666666666665
C Las Vegas,1,11,3,4,7,9,16,14,34,3.0
Allegheny,1,0,0,0,1,4,5,0,5,4.8
Estrella Village,1,0,0,1,0,4,4,0,5,4.6
"Scarborough,",1,3,0,0,0,0,0,3,3,1.0
Mckeesport,1,2,0,1,1,0,1,2,4,2.25
Mount Royal,1,3,0,0,0,0,0,3,3,1.0
Middleburg Hts.,1,5,0,1,0,3,3,5,9,2.5555555555555554
Brunswick Hills,1,1,0,3,4,12,16,1,20,4.3
chandler,1,12,3,5,15,4,19,15,39,2.8974358974358974
Medina Township,2,7,5,9,9,7,16,12,37,3.108108108108108
Las Vegas East,1,3,0,2,4,18,22,3,27,4.2592592592592595
nboulder city,1,20,1,3,3,13,16,21,40,2.7
Charlemagne,1,0,2,0,2,1,3,2,5,3.4
Scarobrough,1,1,2,1,5,11,16,3,20,4.15
St-Laurent,1,0,0,0,2,1,3,0,3,4.333333333333333
Indian land,1,6,0,3,2,2,4,6,13,2.5384615384615383
Central City,1,2,0,3,1,2,3,2,8,3.125
Edinburgh City of,1,0,0,0,1,3,4,0,4,4.75
East Credit,1,1,1,0,1,1,2,2,4,3.0
Scarbrough,1,1,4,0,0,0,0,5,5,1.8
Freiberg,1,0,0,1,2,1,3,0,4,4.0
Inglewood,1,1,1,2,2,2,4,2,8,3.375
Broxburn,1,0,0,1,1,1,2,0,3,4.0
Sun City Grand,1,0,0,0,0,3,3,0,3,5.0
W Henderson,1,30,3,4,21,13,34,33,71,2.7746478873239435
Plum Boro,1,0,0,0,0,4,4,0,4,5.0
Lake Norman,1,6,1,0,0,0,0,7,7,1.1428571428571428
Stetson Valley,1,1,0,0,0,2,2,1,3,3.6666666666666665
Inverkeithing,3,1,2,3,2,3,5,3,11,3.3636363636363638
Warrensville,2,2,1,0,1,5,6,3,9,3.6666666666666665
York Regional Municipality,2,7,3,2,18,10,28,10,40,3.525
Phoenix metro area,1,0,0,0,0,14,14,0,14,5.0
Cote-Saint-Luc,2,3,0,3,1,5,6,3,12,3.4166666666666665
Bentleyville,1,0,0,0,0,3,3,0,3,5.0
Huntingdon,1,0,0,1,0,3,3,0,4,4.5
Indianola,1,0,1,1,0,3,3,1,5,4.0
Harwick,1,0,0,1,0,4,4,0,5,4.6
Kingussie,2,0,0,1,3,3,6,0,7,4.285714285714286
Mt Albert,1,0,3,2,3,1,4,3,9,3.2222222222222223
Ahwahtukee,1,0,0,0,0,15,15,0,15,5.0
Shandwick,1,1,0,1,0,1,1,1,3,3.0
Banksville,1,1,0,0,2,1,3,1,4,3.5
Glbert,1,1,0,0,0,3,3,1,4,4.0
Sainte-Marthe,1,0,0,0,0,3,3,0,3,5.0
Montrose,1,2,1,6,12,62,74,3,83,4.578313253012048
Chagrin Highlands,1,3,0,1,0,0,0,3,4,1.5
San Tan,1,2,3,0,0,0,0,5,5,1.6
Stowe Township,1,2,2,4,5,10,15,4,23,3.8260869565217392
LasVegas,1,18,27,25,26,33,59,45,129,3.2248062015503876
McMasterville,1,0,0,2,0,1,1,0,3,3.6666666666666665
Caledon Village,1,0,0,1,2,1,3,0,4,4.0
North Queensferry,1,4,3,5,10,7,17,7,29,3.4482758620689653
Palmerston,1,1,0,0,1,1,2,1,3,3.3333333333333335
Water of Leith,1,0,0,0,5,2,7,0,7,4.285714285714286
Spring Hill City View,1,1,0,1,0,3,3,1,5,3.8
Chertsey,1,0,1,0,3,1,4,1,5,3.8
St. Anns,1,0,0,0,1,2,3,0,3,4.666666666666667
Sainte-thérèse,1,0,0,1,1,1,2,0,3,4.0
Lambton,1,3,1,0,0,1,1,4,5,2.0
South Mountain,1,12,0,0,0,0,0,12,12,1.0
Auburn Twp,1,2,2,0,2,1,3,4,7,2.7142857142857144
Blackness,1,0,0,2,6,3,9,0,11,4.090909090909091
Woodbridge (Vaughan),1,0,0,1,2,1,3,0,4,4.0
Russellton,2,1,1,0,7,22,29,2,31,4.548387096774194
Aichwald,2,1,0,2,1,2,3,1,6,3.5
Edimbourg,1,0,0,0,0,5,5,0,5,5.0
Green Valley,1,1,0,2,5,6,11,1,14,4.071428571428571
Promenade,1,5,2,1,5,7,12,7,20,3.35
East Loth,1,0,0,0,2,1,3,0,3,4.333333333333333
Fithian,1,0,0,0,2,2,4,0,4,4.5
Bois-Des-Filion,1,0,1,1,1,0,1,1,3,3.0
Ormstown,1,0,0,0,2,1,3,0,3,4.333333333333333
Vieux Montreal,1,3,2,5,13,38,51,5,61,4.327868852459017
Pittsburch,1,2,0,0,0,1,1,2,3,2.3333333333333335
Ahwatukee Foothills Village,1,0,0,0,0,7,7,0,7,5.0
N. Randall,1,0,0,1,2,2,4,0,5,4.2
Brooklyn Hts.,1,0,0,1,2,4,6,0,7,4.428571428571429
"Harrisburg,",1,2,0,0,3,2,5,2,7,3.4285714285714284
Mt. Oliver Boro,1,0,1,1,1,0,1,1,3,3.0
Côte-Saint-Luc,1,0,0,0,0,6,6,0,6,5.0
Saint-Roch-De-L'achigan,1,0,0,0,2,1,3,0,3,4.333333333333333
South Amherst,1,0,0,1,4,5,9,0,10,4.4
Scott Township,1,0,0,2,4,3,7,0,9,4.111111111111111
Bloomfield,1,0,0,1,3,0,3,0,4,3.75
St Joseph,2,0,1,1,4,20,24,1,26,4.653846153846154
Cramond,1,1,0,1,5,0,5,1,7,3.4285714285714284
Stetten,1,0,0,0,1,4,5,0,5,4.8
Scotland,1,0,1,1,0,1,1,1,3,3.3333333333333335
Phx,1,0,0,0,1,1,2,0,2,4.5
Straiton,1,1,1,0,2,0,2,2,4,2.75
Tolono,1,2,2,2,1,0,1,4,7,2.2857142857142856
Richmond Hil,1,13,7,11,18,12,30,20,61,3.1475409836065573
East Liberty,1,9,4,6,8,13,21,13,40,3.3
Münster,1,3,0,0,1,0,1,3,4,1.75
frazer,1,8,3,2,2,3,5,11,18,2.388888888888889
Fitchburgh,1,0,0,0,0,7,7,0,7,5.0
St Leonard,1,1,1,1,5,1,6,2,9,3.4444444444444446
SCOTTSDALE AZ,1,2,1,1,0,7,7,3,11,3.8181818181818183
Mathews,1,3,0,0,0,0,0,3,3,1.0
Lacolle,1,0,0,1,0,2,2,0,3,4.333333333333333
Municipality of Murrysville,1,0,0,0,0,3,3,0,3,5.0
Rural Ridge,1,0,1,0,0,11,11,1,12,4.75
Beauharnois,1,0,0,1,2,0,2,0,3,3.6666666666666665
Indian Lands,1,4,3,5,1,2,3,7,15,2.6
Villa Grove,1,0,0,0,4,1,5,0,5,4.2
Monroeville - Pit.,1,1,1,0,1,1,2,2,4,3.0
110 Las Vegas,1,2,0,0,0,45,45,2,47,4.829787234042553
Sindelfingen/Eichholz,1,0,1,2,1,2,3,1,6,3.6666666666666665
S Concord,1,3,1,0,2,0,2,4,6,2.1666666666666665
Whiitby,1,5,3,1,2,0,2,8,11,2.0
Cooksville,1,2,2,1,0,3,3,4,8,3.0
East Mississauga,1,0,2,5,3,2,5,2,12,3.4166666666666665
Kernen-Stetten,1,0,0,2,1,1,2,0,4,3.75
University Ht,1,0,0,0,0,10,10,0,10,5.0
Dewey,1,1,1,0,0,1,1,2,3,2.6666666666666665
SLOAN,1,1,0,3,0,0,0,1,4,2.5
Nellis,1,1,0,0,1,1,2,1,3,3.3333333333333335
W Spring Valley,1,11,3,7,11,14,25,14,46,3.3043478260869565
N. OLMSTED,1,3,1,0,0,11,11,4,15,4.0
Ste-Therese-de-Blainville,1,0,1,0,0,2,2,1,3,4.0
Newburgh Heights,1,0,0,0,2,2,4,0,4,4.5
Baie-D'urfe,1,1,2,1,4,2,6,3,10,3.4
Citibank,1,2,0,0,0,1,1,2,3,2.3333333333333335
Saint-Bernard-de-Lacolle,1,2,1,3,2,2,4,3,10,3.1
Lavaltrie,1,1,0,1,1,0,1,1,3,2.6666666666666665
